11111111111111
10310000001001
10110111011101
10000101000001
11111101110101
10000100010101
10110111011101
10100000000001
10101101011111
10101001000001
10001011111101
11101000000101
10000111101121
11111111111111